3,5,5,5,5,5,5,3,3,3,3,3,3,3,3,3,3,3,3,3,3,3,3,3,3,3,3,3,3,3,3,3,
5,5,5,5,5,5,5,5,3,3,3,3,3,3,3,3,3,3,3,3,3,3,3,3,3,3,3,3,3,3,3,3,
5,5,5,5,5,5,5,5,6,6,6,6,6,6,6,6,6,6,6,6,6,6,6,6,6,6,6,6,6,6,3,3,
5,5,5,5,5,5,5,5,5,6,6,6,6,6,6,6,6,6,6,6,6,6,6,6,6,6,6,6,6,6,3,3,
5,5,5,5,5,5,5,5,5,6,6,6,6,6,6,6,6,6,6,6,6,6,6,6,6,6,6,6,6,6,3,3,
5,5,5,5,5,5,5,5,5,5,6,6,6,6,6,6,6,6,6,6,6,6,6,6,6,6,6,6,6,6,3,3,
5,5,5,5,5,5,5,5,5,5,6,6,6,6,6,6,6,6,6,6,6,6,6,6,6,6,6,6,6,6,3,3,
5,5,5,5,5,5,5,5,5,5,6,6,6,6,6,6,6,6,6,6,6,6,6,6,6,6,6,6,6,6,3,3,
1,5,5,5,5,5,5,5,5,5,5,6,6,6,6,6,6,6,6,6,6,6,6,6,6,6,6,6,6,6,3,3,
1,5,5,5,5,5,5,5,5,5,5,6,6,6,6,6,6,6,6,6,6,6,6,6,6,6,6,6,6,6,3,3,
0,5,5,5,5,5,5,5,5,5,5,6,6,6,6,6,6,6,6,6,6,6,6,6,6,6,6,6,6,6,3,3,
0,5,5,5,5,5,5,5,5,5,5,6,6,6,6,6,6,6,6,6,6,6,6,6,6,6,6,6,6,6,3,1,
0,5,5,5,5,5,5,5,5,5,5,6,6,6,6,6,6,6,6,6,6,6,6,6,6,6,6,6,6,1,0,0,
1,5,5,5,5,5,5,5,5,5,5,5,6,6,6,6,6,6,6,6,6,6,6,6,6,6,6,1,1,0,0,0,
1,5,5,5,5,5,5,5,5,5,5,5,6,6,6,6,6,6,6,6,6,6,6,6,6,6,1,0,0,0,0,0,
3,5,5,5,5,5,5,5,5,5,5,5,6,6,6,6,6,6,6,6,6,6,6,6,1,0,0,0,0,0,0,0,
3,5,5,5,5,5,5,5,5,5,5,5,6,6,6,6,6,6,6,6,6,6,6,1,0,0,0,0,0,0,0,0,
3,3,5,5,5,5,5,5,5,5,5,5,5,6,6,6,6,6,6,6,6,1,0,0,0,0,0,0,0,0,0,0,
3,3,5,5,5,5,5,5,5,5,5,5,5,6,6,6,6,6,6,6,1,0,0,0,0,0,0,0,0,0,0,0,
3,3,5,5,5,5,5,5,5,5,5,5,5,6,6,6,6,6,6,1,0,0,0,0,0,0,0,0,0,0,0,0,
3,3,6,5,5,5,5,5,5,5,5,5,5,5,6,6,6,6,1,0,0,0,0,0,0,0,0,0,0,0,0,0,
3,3,6,5,5,5,5,5,5,5,5,5,5,5,6,6,6,6,0,0,0,0,0,0,0,0,0,0,0,0,0,0,
3,3,6,5,5,5,5,5,5,5,5,5,5,5,5,6,6,1,0,0,0,0,0,0,0,0,0,0,0,0,0,0,
3,3,6,5,5,5,5,5,5,5,5,5,5,5,5,6,6,1,0,0,0,0,0,0,0,0,0,0,0,0,0,0,
3,3,6,5,5,5,5,5,5,5,5,5,5,5,5,5,6,1,0,0,0,0,0,0,0,0,0,0,0,0,0,1,
3,3,6,5,5,5,5,5,5,5,5,5,5,5,5,5,5,1,0,0,0,0,0,0,0,0,0,0,0,0,1,3,
3,3,5,5,5,5,5,5,2,2,2,5,5,5,5,5,5,1,0,0,0,0,0,0,0,0,0,0,0,1,3,3,
3,3,5,5,5,5,5,2,2,2,2,2,2,5,5,5,5,1,0,0,0,0,0,0,0,0,0,0,1,6,3,3,
3,3,5,5,5,5,5,2,2,2,2,2,2,2,5,5,5,1,1,0,0,0,0,0,0,0,0,1,6,6,3,3,
3,3,5,5,5,5,2,2,2,2,2,2,2,2,2,5,5,5,1,0,0,0,0,0,0,0,1,6,6,6,3,3,
3,5,5,5,5,2,2,2,2,2,2,2,2,2,2,2,5,5,1,1,0,0,0,0,1,1,3,3,3,3,3,3,
3,5,5,5,5,2,2,2,2,2,2,2,2,2,2,2,2,5,5,1,1,1,1,1,3,3,3,3,3,3,3,3,
