3,3,3,3,3,3,3,3,3,3,3,3,5,5,5,5,5,5,5,5,5,2,2,2,2,5,5,5,5,5,5,5,
3,3,3,3,3,3,3,3,3,3,3,3,3,5,5,5,5,5,5,2,2,2,2,2,2,2,2,2,5,5,5,5,
3,3,6,6,6,6,6,6,6,6,6,6,6,5,5,5,5,5,2,2,2,2,2,2,2,2,2,2,2,2,5,5,
3,3,6,6,6,6,6,6,6,6,6,6,6,5,5,5,5,5,2,2,2,2,2,2,2,2,2,2,2,2,2,2,
3,3,6,6,6,6,6,6,6,6,6,6,6,5,5,5,5,2,2,2,2,2,2,2,2,2,2,2,2,2,2,2,
3,3,6,6,6,6,6,6,6,6,6,6,6,5,5,5,5,2,2,2,2,2,2,2,2,2,2,2,2,2,2,2,
3,3,6,6,6,6,6,6,6,6,6,6,6,5,5,5,2,2,2,2,2,2,2,2,2,2,2,2,2,2,2,2,
3,3,6,6,6,6,6,6,6,6,6,6,5,5,5,5,2,2,2,2,2,2,2,2,2,2,2,2,2,2,2,2,
3,3,6,6,6,6,6,6,6,6,6,6,5,5,5,2,2,2,2,2,2,2,2,2,2,2,2,2,2,2,2,2,
3,3,6,6,6,6,6,6,6,6,6,6,5,5,5,2,2,2,2,2,2,2,2,2,2,2,2,2,2,2,2,2,
3,3,6,6,6,6,6,6,6,6,6,5,5,5,2,2,2,2,2,2,2,2,2,2,2,2,2,2,2,2,2,2,
3,3,6,6,6,6,6,6,6,6,5,5,5,5,2,2,2,2,2,2,2,2,2,2,2,2,2,2,2,2,2,2,
3,3,6,6,6,6,6,6,6,6,5,5,5,2,2,2,2,2,2,2,2,2,2,2,2,2,2,2,2,2,2,2,
3,3,6,6,6,6,6,6,6,5,5,5,2,2,2,2,2,2,2,2,2,2,2,2,2,2,2,2,2,2,2,2,
3,3,6,6,6,6,6,6,5,5,5,5,2,2,2,2,2,2,2,2,2,2,2,2,2,2,2,2,2,2,2,2,
3,3,6,6,6,6,6,5,5,5,5,2,2,2,2,2,2,2,2,2,2,2,2,2,2,2,2,2,2,2,2,2,
3,3,6,6,6,6,5,5,5,5,2,2,2,2,2,2,2,2,2,2,2,2,2,2,2,2,2,2,2,2,2,2,
3,3,6,6,6,5,5,5,5,2,2,2,2,2,2,2,2,2,2,2,2,2,2,2,2,2,2,2,2,2,2,2,
3,3,6,5,5,5,5,5,5,2,2,2,2,2,2,2,2,2,2,2,2,2,2,2,2,2,2,2,2,2,2,2,
3,5,5,5,5,5,5,5,2,2,2,2,2,2,2,2,2,2,2,2,2,2,2,2,2,2,2,2,2,2,2,2,
5,5,5,5,5,5,5,2,2,2,2,2,2,2,2,2,2,2,2,2,2,2,2,2,2,2,2,2,2,2,2,2,
5,5,5,5,5,5,2,2,2,2,2,2,2,2,2,2,2,2,2,2,2,2,2,2,2,2,2,2,2,2,2,2,
5,5,5,5,5,2,2,2,2,2,2,2,2,2,2,2,2,2,2,2,2,2,2,2,2,2,2,2,2,2,2,2,
5,5,5,5,5,2,2,2,2,2,2,2,2,2,2,2,2,2,2,2,2,2,2,2,2,2,2,2,2,2,2,2,
5,5,5,5,2,2,2,2,2,2,2,2,2,2,2,2,2,2,2,2,2,2,2,2,2,2,2,2,2,2,2,5,
5,5,5,5,2,2,2,2,2,2,2,2,2,2,1,1,1,2,2,2,2,2,2,2,2,2,2,2,2,2,2,5,
5,5,5,5,2,2,2,2,2,2,2,2,1,1,1,1,1,1,2,2,2,2,2,2,2,2,2,2,2,2,5,5,
5,5,5,5,2,2,2,2,2,2,2,1,1,0,0,0,1,1,2,2,2,2,2,2,2,2,2,2,2,2,5,5,
5,5,5,5,2,2,2,2,2,2,1,1,0,0,0,0,0,1,1,2,2,2,2,2,2,2,2,2,2,2,5,5,
5,5,5,5,2,2,2,2,2,1,1,0,0,0,0,0,0,0,1,2,2,2,2,2,2,2,2,2,2,5,5,5,
5,5,5,5,5,2,2,2,2,1,0,0,0,0,0,0,0,0,1,2,2,2,2,2,2,2,2,2,2,5,5,5,
5,5,5,5,5,2,2,2,1,0,0,0,0,0,0,0,0,0,0,1,2,2,2,2,2,2,2,2,2,5,5,5,
