3,3,3,3,3,3,3,3,3,3,3,3,3,3,3,3,3,3,3,3,3,3,3,3,3,3,3,3,3,3,3,3,
3,3,3,3,3,3,3,3,3,3,3,3,3,3,3,3,3,3,3,3,3,3,3,3,3,3,3,3,3,3,3,3,
3,3,6,6,6,6,6,6,6,6,6,6,6,6,6,6,6,6,6,6,6,6,6,6,6,6,6,6,6,6,3,3,
3,3,6,6,6,6,6,6,6,6,6,6,6,6,6,6,6,6,6,6,6,6,6,6,6,6,6,6,6,6,3,3,
3,3,6,6,6,6,6,6,6,6,6,6,6,6,6,6,6,6,6,6,6,6,6,6,6,6,6,6,6,6,3,3,
3,3,6,6,6,6,6,6,6,6,6,6,6,6,6,6,6,6,6,6,6,6,6,6,6,6,6,6,6,6,3,5,
3,3,6,6,6,6,6,6,6,6,6,6,6,6,6,6,6,6,6,6,6,6,6,6,6,6,6,6,6,6,5,5,
3,3,6,6,6,6,6,6,6,6,6,6,6,6,6,6,6,6,6,6,6,6,6,6,6,6,6,6,6,5,5,5,
3,3,6,6,6,6,6,6,6,6,6,6,6,6,6,6,6,6,6,6,6,6,6,6,6,6,6,6,5,5,5,5,
3,3,6,6,6,6,6,6,6,6,6,6,6,6,6,6,6,6,6,6,6,6,6,6,6,6,5,5,5,5,5,5,
3,3,6,6,6,6,6,6,6,6,6,6,6,6,6,6,6,6,6,6,6,6,6,6,6,5,5,5,5,5,5,5,
3,3,6,6,6,6,6,6,6,6,6,6,6,6,6,6,6,6,6,6,6,6,6,6,5,5,5,5,5,5,5,2,
3,3,6,6,6,6,6,6,6,6,6,6,6,6,6,6,6,6,6,6,6,6,6,5,5,5,5,5,2,2,2,2,
3,3,6,6,6,6,6,6,6,6,6,6,6,6,6,6,6,6,6,6,6,5,5,5,5,5,2,2,2,2,2,2,
3,3,6,6,6,6,6,6,6,6,6,6,6,6,6,6,6,6,6,6,5,5,5,5,5,2,2,2,2,2,2,2,
3,3,6,6,6,6,6,6,6,6,6,6,6,6,6,6,6,6,6,5,5,5,5,2,2,2,2,2,2,2,2,2,
3,3,6,6,6,6,6,6,6,6,6,6,6,6,6,6,6,6,6,5,5,5,2,2,2,2,2,2,2,2,2,2,
3,3,6,6,6,6,6,6,6,6,6,6,6,6,6,6,6,6,5,5,5,2,2,2,2,2,2,2,2,2,2,2,
3,3,6,6,6,6,6,6,6,6,6,6,6,6,6,6,6,5,5,5,5,2,2,2,2,2,2,2,2,2,2,2,
3,3,6,6,6,6,6,6,6,6,6,6,6,6,6,6,6,5,5,5,2,2,2,2,2,2,2,2,2,2,2,2,
3,3,6,6,6,6,6,6,6,6,6,6,6,6,6,6,5,5,5,2,2,2,2,2,2,2,2,2,2,2,2,2,
3,3,6,6,6,6,6,6,6,6,6,6,6,6,6,6,5,5,5,2,2,2,2,2,2,2,2,2,2,2,2,2,
3,3,6,6,6,6,6,6,6,6,6,6,6,6,6,6,5,5,5,2,2,2,2,2,2,2,2,2,2,2,2,2,
3,3,6,6,6,6,6,6,6,6,6,6,6,6,6,6,5,5,5,2,2,2,2,2,2,2,2,2,2,2,2,2,
3,3,6,6,6,6,6,6,6,6,6,6,6,6,6,5,5,5,2,2,2,2,2,2,2,2,2,2,2,2,2,2,
3,3,6,6,6,6,6,6,6,6,6,6,6,6,6,5,5,5,2,2,2,2,2,2,2,2,2,2,2,2,2,2,
3,3,6,6,6,6,6,6,6,6,6,6,6,6,6,5,5,5,2,2,2,2,2,2,2,2,2,2,2,2,2,2,
3,3,6,6,6,6,6,6,6,6,6,6,6,6,6,5,5,5,2,2,2,2,2,2,2,2,2,2,2,2,2,2,
3,3,6,6,6,6,6,6,6,6,6,6,6,6,6,5,5,5,5,2,2,2,2,2,2,2,2,2,2,2,2,2,
3,3,6,6,6,6,6,6,6,6,6,6,6,6,6,5,5,5,5,2,2,2,2,2,2,2,2,2,2,2,2,5,
3,3,3,3,3,3,3,3,3,3,3,3,3,3,3,5,5,5,5,2,2,2,2,2,2,2,2,2,2,2,5,5,
3,3,3,3,3,3,3,3,3,3,3,3,3,3,3,3,5,5,5,5,2,2,2,2,2,2,2,2,2,2,5,5,
